1000111000
1111101111
0010111001
0010101001
1111111111
1010010001
1011110001
1010011111
1110011001
0011111001