1111111111
1010000101
1111111111
1000010001
1111111111
1001000001
1111111111
1010010001
1010010001
1111111111